8.ox
.........o......
..x.............
................
.....o..........
o...............
.......o........
............o...
.............o..
